WWWWWWWW
W  AA  W
W   C  W
W W  B W
W W  B W
W WGG  W
W   G  W
WWWWWWWW
